# Any line followed by a '#' character is ignored
# Section headings must be in square brackets
# Subsections within a section should follow the format:
#   [filename within code directory][tab character \t][subsection title]

[Combinatorial optimization]
Dinic.cc	Dinic's Algo for Sparse max-flow
MinCut.cc	Global min-cut
minCostBipartite.cc	Min cost Bipartite Matching
MinCostMaxFlow.cc	Min cost Max Flow

[Geometry]
ConvexHull.cc	Convex hull
Geometry.cc	Miscellaneous geometry
# Geometry.java	Geometry using Java Libraries
Delaunay.cc	Delaunay Triangulation

[Numerical algorithms]
FFT_new.cc	Fast Fourier transform
Euclid.cc	Euclid and Fermat's Theorem
sieve.cc	Sieve for Prime Numbers
FastExpo.cc	Fast exponentiation
Simplex.cc	Simplex Algorithm, Linear Programming
CSP.cc	Constraint Satisfaction Problem

[Graph algorithms]
# BFS.cc	BFS
# DFS.cc	DFS
FastDijkstra.cc	Fast Dijkstra's algorithm
TopologicalSort.cc	Topological sort (C++)
UnionFind.cc	Union-find set(aka DSU)
SCC.cc	Strongly connected components
BellmanFord.cc	Bellman Ford's algorithm
Kruskal.cc	Minimum Spanning Tree: Kruskal
EulerianPath.cc	Eulerian Path Algo
FloydWarshall.cc	FloydWarshall's Algorithm
Prim_n2.cc	Prim's Algo in $\mathcal{O}(n^2)$ time
Blossom.cc	MST for a directed graph
HopcraftKarp.cc	Maximum Matching in a Bipartite graphss
ArticulationOrBridge.cc	Articulation Pt/Bridge in a Graph
ClosestPair.cc	Closest Pair of points in a 2D Plane

[Data structures]
BIT.cc	Binary Indexed Tree
BIT2D.cc	BIT for 2-D plane questions
LCA.cc	Lowest common ancestor
segTreeN.cc	Segment tree class for range minima query
lazyProp.cc	Lazy Propogation for Range update and Query
RMQ.cc	Range minima query in O(1) tiime using lookup matrix

[String Manipulation]
KMP.cc	Knuth-Morris-Pratt
SuffixArray.cc	Suffix array
ahoCorasick.cc	Aho Corasick Structure for string matching
Tries.cc	Tries Structure for storing strings
Treaps.cc	Treaps Data structure implementation
zAlgo.cc	Z's Algorithm, KMP's Bro

[Miscellaneous]
template.h	C++ template
IO.cc	C++ input/output
LongestIncreasingSubsequence.cc	Longest increasing subsequence
LCS.cc	Longest common subsequence
GaussJordan.cc	Gauss Jordan
MillerRabin.cc	Miller-Rabin Primality Test
BinSearch.cc	Binary Search
Dates.cc	Playing with dates
# regex.java	Regular expressions handling using JAVA
Hash.cc	Hashing
Mobius.cc	Mobius function
Mo.cc	Mo's Algorithm

[Extra]
